{
  "0" : 3,
  "4" : 3,
  "8" : 4,
  "12" : 5,
  "16" : 6,
  "20" : 2,
  "24" : 6,
  "28" : 6,
}
